R 800 600
NO ./textures/bluestone.xpm
SO ./textures/redbrick.xpm
WE ./textures/eagle.xpm
EA ./textures/greystone.xpm
S ./textures/barrel.xpm
F 101,154,182
C 105,105,230

1 1 1 1 1 1 1 1 1 1 1 1 
1 0 2 1 0 0 0 0 0 0 0 1
1 0 0 0 0 1 1 0 1 1 0 1
1 0 1 1 1 2 0 0 0 0 0 1
1 0 0 0 0 0 0 0 1 0 2 1
1 0 1 1 0 2 2 0 0 0 0 1
1 0 0 0 0 2 2 0 1 1 0 1
1 1 2 1 0 0 0 0 1 0 0 1
1 0 0 0 N 0 0 0 1 0 1 1
1 0 2 1 0 1 2 0 2 0 0 1
1 0 0 1 0 1 0 0 0 0 0 1
1 0 0 1 1 0 0 0 0 0 2 1
1 0 0 0 0 0 1 2 0 1 0 1
1 2 0 0 0 2 0 1 0 1 0 1
1 0 0 1 0 1 1 1 0 1 0 1
1 0 0 1 0 0 0 0 0 0 0 1
1 1 1 1 1 1 1 1 1 1 1 1 
